NON, NON, NON, NON, NON, NON, NON, NON, NON, NON, NON, NON, NON, NON, NON, NON, NON, NON, NON, NON, NON, NON, NON, NON, NON, NON, NON, NON, NON, NON, NON, NON, NON, NON, NON, NON, NON, NON, NON, NON, NON, NON, NON, NON, NON, NON, NON, NON, NON, NON, NON, NON, NON, NON, NON, NON, NON, NON, NON, NON, NON, NON, NON, NON, NON, NON, NON, NON, NON, NON, NON, NON, NON, NON, NON, NON, NON, NON, NON, NON, NON, NON, NON, NON, NON, NON, NON, NON, NON, NON, NON, NON, NON, NON, NON, NON, NON, NON, NON, NON, NON, NON, NON, NON, NON, NON, NON, NON, NON, NON, NON, NON, NON, NON, NON, NON, NON, NON, NON, NON, NON, NON, NON, NON, NON, NON, NON, NON, NON, LIZ, NON, NON, NON, NON, NON, NON, NON, NON, NON, NON, NON, NON, NON, NON, NON, NON, NON, NON, NON, NON, NON, NON, NON, NON, NON, NON, NON, NON, NON, NON, NON, NON, NON, NON, NON, NON, NON, NON, NON, NON, NON, NON, NON, NON, NON, NON, NON, NON, NON, NON, NON, NON, NON, NON, NON, NON, NON, NON, NON, NON, NON, NON, NON, NON, NON, NON, NON, NON, NON, NON, NON, NON, NON, NON, NON, NON, NON, NON, NON, NON, NON, NON, NON, NON, NON, NON, NON, NON, NON, NON, NON, NON, NON, NON, NON, NON, NON, NON, NON, NON, NON, NON, NON, NON, NON, NON, NON, NON, NON, NON, NON, NON, NON, NON, NON, NON, NON, NON, NON, NON, NON, NON, NON, NON, NON, NON, NON, NON, NON, NON, NON, NON, NON, NON, NON, NON, NON, NON, NON, NON, NON, NON, NON, NON, NON, NON, NON, NON, NON, NON, NON, NON, NON, NON, NON, NON, NON, NON, NON, NON, NON, NON, NON, NON, FW1,
NON, NON, NON, NON, NON, NON, NON, NON, NON, NON, NON, NON, NON, NON, NON, NON, NON, NON, NON, NON, NON, NON, NON, NON, NON, NON, NON, NON, NON, NON, NON, NON, NON, NON, NON, NON, NON, NON, NON, NON, NON, NON, NON, NON, NON, NON, NON, NON, NON, NON, NON, NON, NON, NON, NON, NON, NON, NON, NON, NON, NON, NON, NON, NON, NON, NON, NON, NON, NON, NON, NON, NON, NON, NON, NON, NON, NON, NON, NON, NON, NON, NON, NON, NON, NON, NON, NON, NON, NON, NON, NON, NON, NON, NON, NON, NON, NON, NON, NON, NON, NON, NON, NON, NON, NON, NON, NON, NON, NON, NON, NON, NON, NON, NON, NON, NON, NON, NON, NON, NON, NON, NON, NON, NON, NON, NON, LIZ, FW1, FN2, FN1, NON, NON, NON, NON, NON, NON, NON, NON, NON, NON, NON, NON, NON, NON, NON, NON, NON, NON, NON, NON, NON, NON, NON, NON, NON, NON, NON, NON, NON, NON, NON, NON, NON, NON, NON, NON, NON, NON, NON, NON, NON, NON, NON, NON, NON, NON, NON, NON, NON, NON, NON, NON, NON, NON, NON, NON, NON, NON, NON, NON, NON, NON, NON, NON, NON, NON, NON, NON, NON, NON, NON, NON, NON, NON, NON, NON, NON, NON, NON, NON, NON, NON, NON, NON, NON, NON, NON, NON, NON, NON, NON, NON, NON, NON, NON, NON, NON, NON, NON, NON, NON, NON, NON, NON, NON, NON, NON, NON, NON, NON, NON, NON, NON, NON, NON, NON, NON, NON, NON, NON, NON, NON, NON, NON, NON, NON, NON, NON, NON, NON, NON, NON, NON, NON, NON, NON, NON, NON, NON, NON, NON, NON, NON, NON, NON, NON, FW1, FN1, NON, FW1, FN1, NON, NON, NON, NON, NON, NON, NON, NON, NON, NON, NON, NON, NON, FS3,
NON, NON, NON, NON, NON, NON, NON, NON, NON, NON, NON, NON, NON, NON, NON, NON, NON, NON, NON, NON, NON, NON, NON, NON, NON, NON, NON, NON, NON, NON, NON, NON, NON, NON, NON, NON, NON, NON, NON, NON, NON, NON, NON, NON, NON, NON, NON, NON, NON, NON, NON, NON, NON, NON, NON, NON, NON, NON, NON, NON, NON, NON, NON, NON, NON, NON, NON, NON, NON, NON, NON, NON, NON, NON, NON, NON, NON, NON, NON, NON, NON, NON, NON, NON, NON, NON, NON, NON, NON, NON, NON, NON, NON, NON, NON, NON, NON, NON, NON, NON, NON, NON, NON, NON, NON, NON, NON, NON, NON, NON, NON, NON, NON, NON, NON, NON, NON, NON, NON, NON, NON, NON, NON, LIZ, FW1, FN2, FW2, FW5, FN4, FE3, NON, NON, NON, NON, NON, NON, NON, NON, NON, NON, NON, NON, NON, NON, NON, NON, NON, NON, NON, NON, NON, NON, NON, NON, NON, NON, NON, NON, NON, NON, NON, NON, NON, NON, NON, NON, NON, NON, NON, NON, NON, NON, NON, NON, NON, NON, NON, NON, NON, NON, NON, NON, NON, NON, NON, NON, NON, NON, NON, NON, NON, NON, NON, NON, NON, NON, NON, NON, NON, NON, NON, NON, NON, NON, NON, NON, NON, NON, NON, NON, NON, NON, NON, NON, NON, NON, NON, NON, NON, NON, NON, NON, NON, NON, NON, NON, NON, NON, NON, NON, NON, NON, NON, NON, NON, NON, NON, NON, NON, NON, NON, NON, NON, NON, NON, NON, NON, NON, NON, NON, NON, NON, NON, NON, NON, NON, NON, NON, NON, NON, NON, NON, NON, NON, NON, NON, NON, NON, NON, NON, NON, NON, NON, NON, NON, NON, FS1, FE1, NON, FS3, FE3, NON, NON, NON, NON, NON, NON, NON, NON, NON, NON, NON, NON, NON, FS3,
NON, NON, NON, NON, NON, NON, NON, NON, NON, NON, NON, NON, NON, NON, NON, NON, NON, NON, NON, NON, NON, NON, NON, NON, NON, NON, NON, NON, NON, NON, NON, NON, NON, NON, NON, NON, NON, NON, NON, NON, NON, NON, NON, NON, NON, NON, NON, NON, NON, NON, NON, NON, NON, NON, NON, NON, NON, NON, NON, NON, NON, NON, NON, NON, NON, NON, NON, NON, NON, NON, NON, NON, NON, NON, NON, NON, NON, NON, NON, NON, NON, NON, NON, NON, NON, NON, NON, NON, NON, NON, NON, NON, NON, NON, NON, NON, NON, NON, NON, NON, NON, NON, NON, NON, NON, NON, NON, NON, NON, NON, NON, NON, NON, NON, NON, NON, NON, NON, NON, LIZ, FW1, FN2, FW2, FN2, FW5, FN4, FE4, FE4, FN4, FE3, NON, NON, NON, NON, NON, NON, NON, NON, NON, NON, NON, NON, NON, NON, NON, NON, NON, NON, NON, NON, NON, NON, NON, NON, NON, NON, NON, NON, NON, NON, NON, LIZ, NON, NON, NON, NON, NON, NON, NON, NON, NON, NON, NON, NON, NON, NON, NON, NON, NON, NON, NON, NON, NON, NON, NON, NON, NON, NON, NON, NON, NON, NON, NON, NON, NON, NON, NON, NON, NON, NON, NON, NON, NON, NON, NON, NON, NON, NON, NON, NON, NON, NON, NON, NON, NON, NON, NON, NON, NON, NON, NON, NON, NON, NON, NON, NON, NON, NON, NON, NON, NON, NON, NON, NON, NON, NON, NON, NON, NON, NON, NON, NON, NON, NON, NON, NON, NON, NON, NON, NON, NON, NON, NON, NON, NON, NON, NON, NON, NON, NON, NON, NON, NON, NON, NON, NON, NON, NON, NON, NON, NON, NON, LIZ, NON, NON, NON, NON, NON, NON, FS3, FE3, NON, NON, NON, NON, NON, NON, NON, NON, NON, NON, NON, NON, NON, FS3,
NON, NON, NON, NON, NON, NON, NON, NON, NON, NON, NON, NON, NON, NON, NON, NON, NON, NON, NON, NON, NON, NON, NON, NON, NON, NON, NON, NON, NON, NON, NON, NON, NON, NON, NON, NON, NON, NON, NON, NON, NON, NON, NON, NON, NON, NON, NON, NON, NON, NON, NON, NON, NON, NON, NON, NON, NON, NON, NON, NON, NON, NON, NON, NON, NON, NON, NON, NON, NON, NON, NON, NON, NON, NON, NON, NON, NON, NON, NON, NON, NON, NON, NON, NON, NON, NON, NON, NON, NON, NON, NON, NON, NON, NON, NON, NON, NON, NON, NON, NON, NON, NON, NON, NON, NON, NON, NON, NON, NON, NON, NON, NON, NON, NON, LIZ, FW1, FN2, FW2, FN2, FW2, FW5, FE4, FE4, FE4, FE4, FN4, FE4, FE4, FN4, FE3, NON, NON, NON, NON, NON, NON, NON, NON, NON, NON, NON, NON, NON, NON, NON, NON, NON, NON, NON, NON, NON, NON, NON, NON, NON, NON, NON, NON, NON, NON, FW1, FN2, FN1, NON, NON, NON, NON, NON, NON, NON, NON, NON, NON, NON, NON, NON, NON, NON, NON, NON, NON, NON, NON, NON, NON, NON, NON, NON, NON, NON, NON, NON, NON, NON, NON, NON, NON, NON, NON, NON, NON, NON, NON, NON, NON, NON, NON, NON, NON, NON, NON, NON, NON, NON, NON, NON, NON, NON, NON, NON, NON, NON, NON, NON, NON, NON, NON, NON, NON, NON, NON, NON, NON, NON, NON, NON, NON, NON, NON, NON, NON, NON, NON, NON, NON, NON, NON, NON, NON, NON, NON, NON, NON, NON, NON, NON, NON, NON, NON, NON, NON, NON, NON, NON, NON, NON, NON, NON, NON, NON, NON, FW1, FN2, FN1, NON, NON, NON, NON, NON, FS3, FE3, NON, NON, NON, NON, NON, NON, NON, NON, NON, NON, NON, NON, NON, FS3,
NON, NON, NON, NON, NON, NON, NON, NON, NON, NON, NON, NON, NON, NON, NON, NON, NON, NON, NON, NON, NON, NON, NON, NON, NON, NON, NON, NON, NON, NON, NON, NON, NON, NON, NON, NON, NON, NON, NON, NON, NON, NON, NON, NON, NON, NON, NON, NON, NON, NON, NON, NON, NON, NON, NON, NON, NON, NON, NON, NON, NON, NON, NON, NON, NON, NON, NON, NON, NON, NON, NON, NON, NON, NON, NON, NON, NON, NON, NON, NON, NON, NON, NON, NON, NON, NON, NON, NON, NON, NON, NON, NON, NON, NON, NON, NON, NON, NON, NON, NON, NON, NON, NON, NON, NON, NON, NON, NON, NON, LIZ, FW1, FN2, FW2, FN2, FN2, FW5, FN4, FN4, FE4, FE4, FE4, FE4, FE4, FE4, FE4, FE4, FE4, FE4, FN4, FE3, NON, NON, NON, NON, NON, NON, NON, NON, NON, NON, NON, NON, NON, NON, NON, NON, NON, NON, NON, NON, NON, NON, NON, NON, NON, NON, LIZ, NON, NON, NON, FS1, FE2, FE1, NON, NON, NON, LIZ, NON, NON, NON, NON, FW1, FN2, FN1, NON, NON, NON, NON, NON, NON, NON, NON, NON, NON, NON, NON, NON, NON, NON, NON, NON, NON, NON, NON, NON, NON, NON, NON, NON, NON, NON, NON, NON, NON, NON, NON, NON, NON, NON, NON, NON, NON, NON, NON, NON, NON, NON, NON, NON, NON, NON, NON, NON, NON, NON, NON, NON, NON, NON, NON, NON, NON, NON, NON, NON, NON, NON, NON, NON, NON, NON, NON, NON, NON, NON, NON, NON, NON, NON, NON, NON, NON, NON, NON, NON, NON, NON, NON, NON, NON, NON, NON, NON, NON, NON, NON, NON, NON, NON, NON, NON, FS1, FE2, FE1, NON, NON, NON, NON, NON, FS3, FE3, NON, NON, NON, NON, NON, NON, NON, NON, NON, NON, NON, NON, NON, FS3,
NON, NON, NON, NON, NON, NON, NON, NON, NON, NON, NON, NON, NON, NON, NON, NON, NON, NON, NON, NON, NON, NON, NON, NON, NON, NON, NON, NON, NON, NON, NON, NON, NON, NON, NON, NON, NON, NON, NON, NON, NON, NON, NON, NON, NON, NON, NON, LIZ, NON, NON, NON, NON, NON, LIZ, NON, NON, NON, NON, NON, NON, NON, NON, NON, NON, NON, NON, NON, NON, NON, NON, NON, NON, NON, NON, NON, NON, NON, NON, NON, NON, NON, NON, NON, NON, NON, NON, NON, NON, NON, NON, NON, NON, NON, NON, NON, NON, NON, NON, NON, NON, NON, NON, NON, LIZ, FW1, FN2, FW2, FN2, FW2, FN2, FW5, FE4, FE4, FE4, FE4, FE4, FE4, FE4, FE4, FE4, FE4, FE4, FE4, FE4, FE4, FE4, FN4, FE4, FN4, FE3, NON, NON, NON, NON, NON, NON, NON, NON, NON, NON, NON, NON, NON, NON, NON, NON, NON, NON, NON, NON, NON, NON, NON, NON, NON, FW1, FN2, FN1, NON, NON, NON, NON, NON, NON, NON, FW1, FN2, FN1, NON, NON, NON, FS1, FE2, FE1, NON, NON, NON, NON, NON, NON, NON, NON, NON, NON, NON, NON, NON, NON, NON, NON, NON, NON, NON, NON, NON, NON, NON, NON, NON, NON, NON, NON, NON, NON, NON, NON, NON, NON, NON, NON, NON, NON, NON, NON, NON, NON, NON, NON, NON, NON, NON, NON, NON, NON, NON, NON, NON, NON, NON, NON, NON, NON, NON, NON, NON, NON, NON, NON, NON, NON, NON, NON, NON, NON, NON, NON, NON, NON, NON, NON, NON, NON, NON, NON, NON, NON, NON, NON, NON, NON, NON, NON, NON, NON, NON, NON, NON, NON, NON, NON, NON, NON, NON, NON, NON, NON, NON, NON, NON, FS3, FE3, NON, NON, NON, NON, NON, NON, NON, NON, NON, NON, NON, NON, NON, FS3,
NON, NON, NON, NON, NON, NON, NON, NON, NON, NON, NON, NON, NON, NON, NON, NON, NON, NON, NON, NON, NON, NON, NON, NON, NON, NON, NON, NON, NON, NON, NON, NON, NON, NON, NON, NON, NON, NON, NON, NON, NON, NON, NON, NON, NON, NON, FW1, FN2, FN1, NON, NON, NON, FW1, FN2, FN1, NON, NON, NON, NON, NON, TCH, NON, NON, NON, NON, NON, NON, NON, NON, NON, NON, NON, NON, NON, NON, NON, NON, NON, NON, NON, NON, NON, NON, NON, NON, NON, NON, NON, NON, NON, NON, NON, NON, LIZ, FW1, FN2, FW2, FN2, FW2, FN2, FW2, FN2, FW2, FN2, FW5, FE4, FE4, FE4, FE4, FE4, FE4, FE4, FE4, FE4, FE4, FE4, FE4, FE4, FE4, FE4, FE4, FE4, FE4, FE4, FE4, FE4, FN4, FN4, FN4, FE3, NON, NON, NON, NON, NON, NON, NON, NON, NON, NON, NON, NON, NON, NON, NON, NON, NON, NON, NON, NON, NON, NON, NON, NON, NON, FS1, FE2, FE1, NON, NON, NON, NON, NON, NON, NON, FS1, FE2, FE1, NON, NON, NON, NON, NON, NON, NON, NON, NON, FW1, FN2, FW2, FN2, FN1, NON, NON, NON, NON, NON, NON, NON, NON, NON, NON, NON, NON, NON, NON, NON, NON, NON, NON, NON, NON, NON, NON, NON, NON, NON, NON, NON, NON, NON, NON, NON, NON, NON, NON, NON, NON, NON, NON, NON, NON, NON, NON, NON, NON, NON, NON, NON, NON, NON, NON, NON, NON, NON, NON, NON, NON, NON, NON, NON, NON, NON, NON, NON, NON, NON, NON, NON, NON, NON, NON, NON, NON, NON, NON, NON, NON, NON, NON, NON, NON, NON, NON, NON, NON, NON, NON, NON, NON, NON, NON, NON, NON, NON, NON, FW1, FN1, NON, FS3, FE3, NON, NON, NON, NON, NON, NON, NON, NON, NON, NON, NON, NON, NON, FS3,
NON, NON, NON, NON, NON, NON, NON, NON, NON, NON, NON, NON, NON, NON, LIZ, NON, NON, NON, NON, NON, NON, NON, LIZ, FW1, FN2, FW2, FN1, NON, NON, NON, NON, NON, FW1, FN2, FW2, FN1, NON, NON, NON, NON, NON, NON, NON, NON, NON, NON, FS1, FE2, FE1, NON, NON, NON, FS1, FE2, FE1, NON, NON, NON, FW1, FN2, FW2, FN1, NON, NON, NON, NON, NON, NON, NON, NON, NON, NON, NON, NON, NON, NON, NON, NON, NON, NON, NON, NON, NON, NON, NON, LIZ, FW1, FN2, FW2, FN2, FW2, FN2, FW2, FN2, FW5, FN4, FN4, FN4, FN4, FN4, FN4, FN4, FN4, FN4, FN4, FE4, FE4, FE4, FE4, FE4, FE4, FE4, FE4, FE4, FE4, FE4, FE4, FE4, FE4, FE4, FE4, FE4, FE4, FE4, FE4, FE4, FN4, FN4, FN4, FE3, NON, NON, NON, NON, NON, NON, NON, NON, NON, NON, NON, NON, NON, NON, NON, NON, NON, NON, FW1, FN2, FW2, FN1, NON, NON, NON, NON, NON, NON, NON, NON, NON, NON, NON, NON, NON, NON, NON, NON, NON, NON, NON, NON, NON, NON, NON, NON, NON, FS3, FE4, FE4, FE4, FE3, NON, NON, NON, NON, NON, NON, NON, NON, NON, NON, NON, NON, NON, NON, NON, NON, NON, NON, NON, NON, NON, NON, NON, NON, NON, NON, NON, NON, NON, NON, NON, NON, NON, NON, NON, NON, NON, NON, NON, FW1, FN2, FW2, FN2, FN2, FW2, FN1, NON, NON, NON, NON, NON, NON, NON, NON, NON, NON, NON, NON, NON, NON, NON, NON, NON, NON, NON, NON, NON, NON, NON, NON, NON, NON, NON, NON, NON, NON, NON, NON, NON, NON, NON, NON, NON, NON, NON, NON, NON, NON, NON, NON, NON, NON, NON, NON, FS1, FE1, NON, FS3, FE3, NON, NON, NON, NON, NON, NON, NON, NON, NON, NON, NON, NON, NON, FS3,
NON, NON, NON, NON, NON, NON, NON, NON, NON, NON, NON, NON, FW1, FN2, FW2, FN2, FW2, FN2, FW2, FN2, FW2, FN2, FW2, FW5, FE2, FE2, FE1, NON, NON, NON, NON, NON, FS1, FE2, FS2, FN5, FN2, FW2, FN2, FW2, FW2, FN1, NON, NON, NON, NON, NON, NON, NON, NON, NON, NON, NON, NON, NON, NON, NON, NON, FS1, FS5, FE5, FE1, NON, NON, NON, NON, NON, NON, NON, NON, NON, NON, NON, NON, NON, LIZ, FW1, FN2, FW2, FN2, FW2, FN2, FW2, FN2, FW2, FN2, FW5, FN4, FN4, FN4, FN4, FN4, FN4, FN4, FN4, FN4, FN4, FN4, FN4, FN4, FN4, FN4, FN4, FN4, FN4, FE4, FE4, FE4, FE4, FE4, FE4, FE4, FE4, FE4, FE4, FE4, FE4, FE4, FE4, FE4, FE4, FE4, FE4, FE4, FE4, FE4, FN4, FN4, FN4, FE3, NON, NON, NON, NON, NON, NON, NON, TCH, NON, NON, NON, NON, NON, NON, NON, NON, NON, NON, FW3, FN4, FN4, FE3, NON, NON, NON, NON, NON, NON, NON, NON, NON, NON, NON, NON, NON, NON, NON, NON, NON, NON, NON, NON, NON, NON, NON, FW1, FN2, FW5, FE4, FE4, FE4, FE3, NON, NON, NON, NON, NON, NON, NON, NON, NON, NON, NON, NON, NON, NON, NON, NON, NON, LIZ, NON, NON, NON, NON, NON, NON, NON, NON, NON, NON, NON, NON, NON, NON, NON, NON, NON, NON, NON, NON, NON, FS1, FS2, FE2, FE2, FS2, FS5, FE3, NON, NON, NON, NON, NON, NON, NON, NON, NON, NON, NON, LIZ, NON, NON, NON, NON, NON, LIZ, NON, NON, NON, NON, NON, LIZ, NON, NON, NON, NON, NON, LIZ, NON, NON, NON, NON, NON, NON, NON, NON, FW1, FN2, FW2, FN1, NON, NON, NON, NON, NON, NON, NON, NON, NON, FS3, FE3, NON, NON, NON, NON, NON, NON, NON, NON, NON, NON, NON, NON, NON, FS3,
MCH, NON, NON, NON, NON, NON, NON, WIZ, NON, NON, NON, NON, FS3, FE4, FE4, FS4, FE4, FE4, FE4, FE4, FE4, FE4, FE4, FE5, TCN, NON, NON, LIZ, NON, NON, NON, LIZ, NON, NON, TCH, FS5, FN4, FE4, FN4, FE4, FN4, FE3, NON, NON, NON, NON, NON, NON, NON, NON, LIZ, NON, NON, NON, NON, NON, NON, NON, TCN, FS3, FN3, TCM, NON, NON, NON, NON, NON, NON, LIZ, FW1, FN2, FW2, FN2, FW2, FN2, FW2, FW5, FE4, FE4, FE4, FN4, FN4, FN4, FN4, FN4, FN4, FN4, FN4, FN4, FN4, FN4, FN4, FN4, FN4, FN4, FN4, FN4, FN4, FN4, FN4, FN4, FN4, FN4, FN4, FN4, FE4, FE4, FE4, FE4, FE4, FE4, FE4, FE4, FE4, FE4, FE4, FE4, FE4, FE4, FE4, FE4, FE4, FE4, FE4, FE4, FE4, FN4, FN4, FN4, FE3, NON, NON, NON, NON, NON, NON, FW1, FN2, FN1, NON, NON, NON, NON, NON, NON, NON, NON, NON, FW3, FN4, FN4, FE3, NON, NON, NON, NON, NON, NON, NON, NON, NON, LIZ, NON, NON, NON, NON, NON, NON, NON, NON, LIZ, NON, NON, NON, NON, FS3, FE4, FE4, FE4, FE4, FE4, FE3, NON, NON, NON, LIZ, NON, NON, NON, NON, NON, NON, LIZ, NON, NON, NON, NON, FW1, FW2, FN2, FN1, NON, NON, NON, NON, LIZ, NON, NON, NON, NON, NON, NON, LIZ, NON, NON, NON, NON, NON, NON, NON, LIZ, NON, NON, TCN, TCM, TCH, FW3, FE3, NON, NON, NON, NON, NON, NON, NON, NON, NON, NON, FW1, FN2, FN1, NON, NON, NON, FW1, FN2, FN1, NON, NON, NON, FW1, FN2, FN1, NON, LIZ, NON, FW1, FN2, FN1, NON, NON, NON, NON, NON, NON, NON, FS3, FE4, FE4, FE3, NON, NON, NON, NON, LIZ, NON, NON, NON, NON, FS3, FE3, NON, NON, NON, NON, NON, NON, NON, NON, NON, NON, NON, NON, BIZ, FS3,
FW1, FN2, FW2, FW2, FN2, FW2, FN2, FW2, FN2, FW2, FN2, FW2, FW5, FE4, FE4, FE4, FE4, FE4, FE4, FE4, FE4, FS4, FE4, FN5, FN2, FW2, FN2, FW2, FN2, FW2, FN2, FW2, FN2, FW2, FN2, FW5, FE4, FE4, FS4, FE4, FN4, FN5, FN2, FW2, FN2, FW2, FN2, FW2, FN2, FW2, FN2, FW2, FN2, FW2, FN2, FW2, FN2, FW2, FN2, FW5, FN5, FN2, FW2, FN2, FN2, FW2, FN2, FW2, FN2, FW5, FE4, FE4, FE4, FE4, FE4, FE4, FE4, FE4, FE4, FE4, FN4, FN4, FN4, FN4, FN4, FN4, FN4, FN4, FN4, FN4, FN4, FN4, FN4, FN4, FN4, FN4, FN4, FN4, FN4, FN4, FN4, FN4, FN4, FN4, FN4, FE4, FE4, FE4, FE4, FE4, FE4, FE4, FE4, FE4, FE4, FE4, FE4, FE4, FE4, FE4, FE4, FE4, FE4, FE4, FE4, FE4, FN4, FN4, FN4, FN5, FN2, FW2, FN2, FW2, FN2, FW2, FW5, FN4, FN5, FW2, FN2, FW2, FN2, FW2, FN2, FW2, FN2, FW2, FW5, FN4, FN4, FN5, FW2, FN2, FW2, FN2, FW2, FN2, FW2, FN2, FN2, FW2, FN2, FW2, FN2, FW2, FN2, FW2, FN2, FW2, FN2, FW2, FN2, FW2, FN2, FW5, FE4, FE4, FE4, FE4, FE4, FN5, FN2, FW2, FN2, FW2, FN2, FN2, FW2, FN2, FW2, FN2, FW2, FN2, FW2, FN2, FW2, FW5, FN4, FN4, FN5, FN2, FW2, FN2, FW2, FN2, FW2, FN2, FW2, FN2, FW2, FN2, FN2, FW2, FN2, FW2, FN2, FW2, FN2, FW2, FN2, FW2, FN2, FW2, FN2, FW2, FW5, FN5, FN2, FW2, FN2, FW2, FN2, FW2, FN2, FW2, FN2, FW2, FW5, FN4, FN5, FN2, FW2, FN2, FW5, FN4, FN5, FN2, FW2, FN2, FW5, FN4, FN5, FN2, FW2, FN2, FW5, FN4, FN5, FN2, FW2, FN2, FW2, FN2, FN2, FW2, FW5, FE4, FE4, FN5, FN2, FW2, FN2, FW2, FN2, FW2, FN2, FW2, FN2, FW5, FN5, FW2, FN2, FW2, FN2, FW2, FN2, FW2, FN2, FW2, FN2, FW2, FN2, FW2, FW5
