NON, NON, NON, NON, NON, NON, NON, NON, NON, NON, NON, NON, NON, NON, NON, NON, NON, NON, NON, NON, NON, NON, NON, NON, NON, NON, NON, NON, NON, NON, NON, NON, NON, NON, NON, NON, NON, NON, NON, NON, NON, NON, NON, NON, NON, NON, NON, NON, NON, NON, NON, GOB, NON, NON, NON, NON, NON, NON, NON, NON, NON, GOB, NON, NON, NON, NON, NON, NON, NON, NON, NON, NON, NON, NON, NON, NON, NON, NON, NON, NON, NON, NON, NON, NON, NON, NON, NON, NON, NON, NON, NON, NON, NON, NON, NON, NON, NON, NON, NON, NON, NON, NON, NON, NON, NON, NON, NON, NON, NON, NON, NON, NON, NON, NON, NON, NON, NON, NON, NON, NON, NON, NON, NON, NON, NON, NON, NON, NON, NON, NON, NON, NON, NON, NON, NON, NON, NON, NON, NON, NON, NON, NON, NON, NON, NON, NON, NON, NON, NON, NON, NON, NON, NON, NON, NON, NON, NON, NON, NON, NON, NON, NON, NON, NON, NON, NON, NON, NON, NON, NON, NON, NON, NON, NON, NON, NON, NON, NON, NON, NON, NON, NON, NON, NON, NON, NON, NON, NON, NON, NON, NON, NON, NON, NON, NON, NON, NON, NON, NON, NON, NON, NON, NON, NON, NON, NON, NON, NON, NON, NON, NON, NON, NON, NON, NON, NON, NON, NON, NON, NON, NON, NON, NON, NON, NON, NON, NON, NON, NON, NON, NON, NON, NON, NON, NON, NON, NON, NON, NON, NON, NON, NON, NON, NON, NON, NON, NON, NON, NON, NON, NON, NON, NON, NON, NON, NON, NON, NON, NON, NON,
NON, NON, NON, NON, NON, NON, NON, NON, NON, NON, NON, NON, NON, NON, NON, NON, NON, NON, NON, IW1, IN1, NON, NON, NON, NON, NON, NON, NON, NON, NON, NON, NON, NON, NON, NON, NON, NON, NON, NON, NON, NON, NON, NON, NON, IW1, IN2, IN1, WW1, WE2, WW2, WE2, WW2, WE2, WE2, WE2, WW2, WW2, WE2, WW2, WE2, WW2, WE2, WE2, WW2, WE1, IW1, IN1, NON, NON, NON, NON, NON, NON, NON, NON, NON, NON, NON, NON, NON, NON, NON, NON, NON, NON, NON, NON, NON, NON, NON, NON, NON, NON, NON, NON, NON, NON, NON, NON, NON, NON, NON, NON, NON, NON, NON, NON, NON, NON, NON, NON, NON, NON, GOB, NON, NON, NON, NON, NON, NON, NON, NON, IW1, IN1, NON, NON, NON, IW1, IN1, NON, NON, NON, NON, NON, NON, NON, NON, NON, NON, NON, NON, NON, NON, NON, NON, NON, NON, NON, NON, NON, NON, NON, NON, NON, NON, NON, NON, NON, NON, NON, NON, NON, NON, NON, NON, NON, NON, NON, NON, NON, NON, NON, NON, NON, NON, NON, GOB, NON, NON, NON, NON, NON, NON, NON, NON, NON, NON, NON, NON, NON, NON, NON, NON, NON, NON, NON, NON, NON, NON, NON, NON, NON, NON, NON, NON, NON, NON, NON, NON, NON, NON, NON, NON, NON, NON, NON, NON, NON, NON, NON, NON, GOB, NON, NON, NON, NON, NON, NON, NON, NON, NON, NON, NON, NON, NON, NON, NON, NON, NON, NON, NON, NON, NON, NON, NON, IW1, IN1, NON, NON, NON, NON, NON, NON, NON, NON, NON, NON, NON, NON, IW1,
NON, MCH, NON, NON, NON, NON, NON, IW1, IN1, NON, NON, NON, NON, WIZ, NON, NON, NON, NON, NON, IS1, IE1, NON, NON, NON, NON, NON, NON, NON, NON, NON, NON, NON, NON, NON, IW1, IN1, NON, NON, NON, IW1, IN1, NON, NON, NON, IS1, IE2, IE1, NON, NON, NON, NON, NON, NON, NON, NON, NON, NON, NON, NON, NON, NON, NON, NON, NON, NON, IS1, IE1, NON, NON, NON, NON, NON, NON, NON, NON, NON, NON, NON, NON, NON, NON, NON, NON, NON, NON, NON, NON, NON, NON, NON, NON, NON, NON, NON, NON, NON, NON, NON, NON, NON, NON, NON, NON, NON, NON, NON, NON, NON, NON, NON, NON, NON, NON, NON, NON, NON, NON, NON, NON, NON, NON, NON, IS1, IE1, NON, NON, NON, IS3, IN3, NON, NON, NON, NON, NON, NON, NON, NON, NON, NON, NON, NON, NON, NON, NON, NON, NON, NON, NON, NON, NON, NON, NON, NON, NON, NON, NON, NON, NON, NON, NON, NON, NON, NON, NON, NON, NON, NON, NON, NON, NON, NON, NON, NON, NON, NON, NON, NON, NON, NON, NON, NON, NON, NON, NON, IW1, IN1, WW1, WE2, WW2, WE2, WE1, NON, NON, NON, NON, NON, NON, NON, NON, NON, NON, NON, GOB, NON, NON, NON, NON, NON, NON, NON, NON, NON, NON, NON, NON, NON, NON, NON, NON, NON, NON, NON, NON, NON, NON, NON, NON, NON, NON, NON, NON, NON, NON, NON, NON, NON, NON, NON, NON, NON, NON, NON, NON, IW1, IN2, IW5, IE3, NON, NON, NON, NON, NON, NON, NON, NON, NON, NON, NON, NON, IW3,
IW1, IN2, IN1, NON, NON, NON, NON, IS1, IE1, NON, NON, NON, IW1, IN2, IW2, IN1, NON, NON, NON, NON, NON, NON, NON, NON, NON, NON, IW1, IN2, IW2, IN1, NON, NON, NON, NON, IS1, IE1, NON, NON, NON, IS1, IE1, NON, NON, NON, NON, NON, NON, NON, NON, NON, NON, NON, NON, NON, NON, NON, NON, NON, NON, NON, NON, NON, NON, NON, NON, NON, NON, NON, NON, NON, NON, NON, NON, NON, NON, NON, TCM, NON, NON, NON, NON, NON, NON, NON, NON, NON, NON, NON, NON, NON, NON, NON, NON, NON, NON, NON, NON, NON, NON, NON, NON, NON, NON, NON, NON, NON, NON, NON, NON, NON, NON, NON, IW1, IN2, IN1, NON, NON, IW1, IN1, NON, NON, NON, NON, NON, NON, NON, NON, IS3, IN3, NON, NON, NON, NON, NON, NON, NON, NON, NON, NON, NON, NON, NON, NON, NON, NON, NON, NON, NON, NON, NON, NON, NON, NON, NON, NON, NON, NON, NON, NON, NON, NON, NON, NON, NON, NON, NON, NON, NON, NON, NON, NON, NON, NON, NON, IW1, IN1, IN1, NON, NON, IW1, IN1, NON, NON, NON, IS1, IE1, NON, NON, NON, NON, NON, NON, NON, NON, NON, NON, NON, NON, TCN, NON, NON, NON, NON, NON, NON, NON, NON, NON, NON, NON, NON, NON, NON, NON, NON, NON, NON, NON, NON, NON, IW1, IN1, NON, NON, NON, NON, NON, NON, NON, NON, NON, NON, NON, NON, NON, NON, NON, NON, NON, NON, NON, NON, NON, IS1, IE2, IS5, IE3, NON, NON, NON, NON, NON, NON, NON, NON, NON, NON, NON, NON, IW3,
IS1, IE2, IE1, NON, NON, NON, NON, NON, NON, NON, NON, NON, IS1, IE2, IS2, IE1, NON, NON, NON, NON, NON, NON, NON, NON, NON, NON, IS1, IE2, IS2, IE1, NON, NON, NON, NON, NON, NON, NON, NON, NON, NON, NON, NON, NON, NON, NON, NON, NON, NON, NON, NON, NON, NON, NON, NON, NON, NON, NON, NON, NON, NON, NON, NON, NON, NON, NON, NON, NON, NON, NON, NON, NON, NON, NON, NON, NON, IW1, IN2, IN1, NON, NON, NON, NON, NON, NON, NON, NON, NON, NON, NON, NON, NON, NON, NON, NON, NON, NON, NON, NON, NON, NON, NON, NON, NON, NON, NON, NON, NON, NON, NON, NON, NON, NON, IS1, IE2, IE1, NON, NON, IS1, IE1, NON, NON, NON, NON, NON, NON, NON, NON, IS3, IN3, NON, NON, NON, NON, NON, NON, NON, NON, NON, NON, NON, NON, NON, NON, NON, NON, NON, NON, NON, NON, NON, NON, NON, NON, NON, NON, NON, NON, NON, NON, NON, NON, NON, NON, NON, NON, NON, NON, GOB, NON, NON, NON, NON, NON, NON, IS1, IE2, IE1, NON, NON, IW3, IE3, NON, NON, NON, NON, NON, NON, NON, NON, NON, NON, NON, NON, NON, NON, NON, WW1, WE2, WE2, WE2, IW1, IN1, NON, NON, NON, NON, NON, NON, NON, NON, NON, NON, NON, NON, NON, NON, NON, NON, NON, NON, IS1, IE1, NON, NON, NON, NON, NON, NON, NON, NON, NON, NON, NON, GOB, NON, NON, NON, NON, NON, IW1, IN2, IN1, NON, NON, NON, IW3, IE3, NON, NON, NON, NON, NON, NON, NON, NON, NON, NON, NON, NON, IW3,
NON, NON, NON, NON, NON, NON, NON, NON, NON, NON, NON, NON, NON, NON, NON, NON, NON, NON, NON, NON, NON, NON, NON, NON, NON, NON, NON, NON, NON, NON, NON, NON, NON, NON, NON, NON, NON, NON, NON, NON, NON, NON, NON, NON, NON, NON, NON, NON, NON, NON, NON, NON, NON, NON, NON, NON, NON, NON, NON, NON, NON, NON, NON, NON, NON, NON, NON, NON, NON, NON, NON, NON, NON, NON, NON, IS1, IE2, IE1, NON, NON, NON, NON, NON, NON, NON, NON, NON, NON, NON, NON, NON, NON, NON, NON, NON, NON, NON, NON, NON, NON, NON, NON, NON, NON, NON, NON, NON, IW1, IN2, IN1, NON, NON, NON, NON, NON, NON, NON, NON, NON, NON, NON, NON, NON, NON, NON, NON, NON, IS3, IN3, NON, NON, NON, NON, NON, NON, NON, NON, NON, NON, NON, NON, NON, NON, NON, NON, NON, NON, NON, NON, NON, NON, NON, NON, GOB, NON, NON, NON, NON, NON, NON, NON, NON, NON, NON, NON, NON, NON, NON, NON, NON, NON, NON, NON, NON, NON, NON, NON, NON, NON, IW3, IE3, NON, NON, NON, NON, NON, NON, NON, NON, NON, NON, NON, NON, NON, NON, NON, NON, NON, NON, NON, IS1, IE1, NON, NON, NON, NON, NON, NON, NON, NON, NON, NON, NON, NON, GOB, NON, NON, NON, NON, NON, NON, NON, NON, NON, NON, IW1, IN1, NON, NON, NON, NON, NON, NON, NON, NON, NON, NON, NON, NON, IS1, IE2, IE1, NON, NON, NON, IW3, IE3, NON, NON, NON, NON, NON, NON, NON, NON, NON, NON, NON, NON, IW3,
NON, NON, NON, NON, NON, NON, NON, NON, NON, NON, NON, NON, NON, NON, NON, NON, NON, NON, NON, NON, NON, NON, IW1, IN2, IN1, NON, NON, NON, NON, NON, NON, NON, NON, NON, NON, NON, NON, NON, NON, NON, NON, NON, NON, NON, NON, NON, NON, NON, GOB, NON, NON, NON, NON, NON, NON, NON, NON, NON, NON, NON, NON, NON, NON, TCH, NON, NON, NON, TCN, NON, NON, NON, NON, NON, NON, NON, NON, NON, NON, NON, NON, NON, NON, NON, NON, NON, GOB, NON, NON, NON, NON, NON, NON, NON, NON, NON, NON, NON, NON, NON, NON, NON, NON, NON, NON, NON, NON, NON, IS1, IE2, IE1, NON, NON, NON, NON, NON, NON, NON, NON, NON, NON, NON, NON, NON, NON, NON, NON, NON, IS3, IN3, NON, NON, NON, NON, NON, NON, NON, NON, NON, NON, NON, NON, NON, NON, NON, NON, NON, NON, NON, NON, NON, NON, NON, NON, NON, NON, NON, IW1, IN1, NON, NON, NON, NON, NON, NON, NON, NON, NON, NON, NON, NON, IW1, IN1, NON, NON, NON, NON, NON, NON, NON, IW3, IE3, NON, NON, NON, NON, NON, NON, NON, NON, NON, NON, NON, NON, NON, NON, NON, NON, NON, NON, NON, NON, NON, NON, NON, NON, NON, NON, NON, NON, NON, NON, NON, NON, NON, NON, NON, IW1, IN1, NON, NON, NON, NON, NON, NON, NON, IS1, IE1, NON, NON, NON, IW1, IN1, NON, NON, NON, IW1, IN1, NON, NON, NON, NON, NON, NON, NON, NON, IW3, IE3, NON, NON, NON, NON, NON, NON, NON, NON, NON, NON, NON, NON, IW3,
NON, NON, NON, NON, NON, NON, NON, NON, NON, NON, NON, NON, NON, NON, NON, NON, NON, NON, NON, NON, NON, NON, IS1, IE2, IE1, NON, NON, NON, NON, NON, NON, NON, NON, NON, NON, NON, NON, NON, NON, NON, NON, NON, NON, NON, NON, NON, NON, IW1, IN2, IW2, IN1, NON, NON, NON, IW1, IN1, NON, NON, NON, IW1, IN2, IW2, IN2, IW2, IN2, IW2, IN2, IW2, IN2, IW2, IN2, IN1, NON, NON, NON, NON, NON, NON, NON, NON, NON, NON, NON, NON, IW1, IN2, IN1, NON, NON, IW1, IN2, IN1, NON, NON, NON, GOB, TCH, NON, NON, NON, NON, NON, IW1, IN2, IN1, NON, NON, NON, NON, NON, NON, NON, NON, NON, NON, NON, NON, NON, NON, NON, NON, NON, NON, NON, NON, NON, NON, IS3, IN3, NON, NON, NON, NON, NON, NON, NON, NON, NON, NON, NON, NON, NON, NON, NON, NON, NON, NON, NON, NON, NON, NON, NON, NON, NON, NON, NON, IS1, IE1, NON, NON, NON, TCH, NON, NON, NON, NON, NON, NON, NON, NON, IS1, IE1, NON, NON, NON, NON, NON, NON, NON, IW3, IE3, NON, NON, NON, NON, NON, NON, NON, NON, NON, NON, NON, NON, NON, NON, NON, NON, NON, NON, NON, NON, NON, NON, NON, NON, NON, NON, NON, NON, NON, NON, NON, NON, NON, NON, NON, IS1, IE1, NON, NON, NON, NON, NON, NON, NON, NON, NON, NON, NON, NON, IS1, IE1, NON, NON, NON, IS1, IE1, NON, NON, NON, NON, NON, NON, NON, NON, IW3, IE3, NON, NON, NON, NON, NON, NON, NON, NON, NON, NON, NON, NON, IW3,
NON, NON, NON, NON, NON, NON, NON, NON, NON, NON, NON, NON, NON, NON, NON, NON, NON, NON, NON, NON, NON, NON, NON, NON, NON, NON, NON, NON, NON, NON, NON, NON, NON, NON, NON, NON, NON, NON, NON, NON, NON, NON, NON, NON, NON, NON, NON, IS1, IE2, IS2, IE1, NON, NON, NON, IS1, IE1, NON, NON, NON, IS3, IN4, IN4, IN4, IN4, IN4, IN4, IN4, IN4, IN4, IN4, IN4, IE3, NON, NON, NON, NON, NON, NON, NON, NON, NON, NON, NON, NON, IS1, IE2, IE1, NON, NON, IS1, IE2, IE1, NON, NON, IW1, IN2, IW2, IN1, NON, NON, NON, NON, IS1, IE2, IE1, NON, NON, NON, NON, NON, NON, NON, NON, NON, NON, NON, NON, NON, NON, NON, NON, NON, NON, NON, NON, NON, NON, IS3, IN3, NON, NON, NON, NON, NON, NON, NON, NON, NON, NON, NON, NON, NON, NON, NON, NON, NON, NON, NON, NON, NON, NON, IW1, IN1, NON, NON, NON, NON, NON, NON, NON, IW1, IN2, IN1, NON, NON, NON, NON, NON, NON, NON, NON, NON, NON, NON, IW1, IN1, NON, NON, NON, IW3, IE3, NON, NON, NON, NON, NON, NON, NON, NON, NON, NON, NON, NON, NON, NON, NON, NON, NON, NON, NON, NON, NON, NON, NON, NON, GOB, NON, NON, NON, IW1, IN2, IW2, IN1, NON, NON, NON, NON, NON, NON, NON, NON, NON, NON, NON, NON, NON, NON, NON, NON, NON, NON, NON, NON, NON, NON, NON, NON, NON, NON, NON, NON, NON, NON, NON, NON, IW3, IE3, NON, NON, NON, NON, NON, NON, NON, NON, NON, NON, NON, NON, IW3,
NON, NON, NON, NON, NON, NON, NON, NON, NON, NON, NON, NON, NON, NON, NON, NON, NON, NON, NON, NON, NON, NON, NON, NON, NON, NON, NON, NON, NON, NON, NON, NON, NON, NON, NON, NON, NON, NON, NON, NON, NON, NON, NON, NON, NON, NON, NON, NON, NON, NON, NON, NON, NON, NON, NON, NON, NON, NON, NON, IS3, IN4, IN4, IN4, IN4, IN4, IN4, IN4, IN4, IN4, IN4, IN4, IE3, NON, NON, NON, NON, NON, NON, NON, NON, NON, NON, NON, NON, NON, NON, NON, NON, NON, NON, NON, NON, NON, NON, IS1, IE2, IS2, IE1, NON, NON, NON, NON, NON, NON, NON, NON, NON, NON, NON, NON, NON, NON, NON, NON, NON, NON, NON, NON, NON, NON, NON, NON, NON, NON, NON, NON, NON, IS3, IN3, NON, NON, NON, NON, NON, NON, NON, GOB, NON, NON, NON, NON, NON, NON, NON, GOB, NON, NON, NON, NON, NON, NON, IS1, IE1, NON, NON, NON, NON, NON, NON, NON, IS3, IN4, IE3, NON, NON, NON, NON, NON, NON, NON, NON, NON, NON, NON, IS1, IE1, NON, NON, NON, IW3, IE3, NON, NON, NON, NON, NON, NON, NON, NON, GOB, NON, NON, NON, NON, NON, NON, NON, GOB, NON, NON, NON, NON, NON, NON, NON, NON, NON, NON, NON, IW3, IE4, IE4, IE3, NON, NON, NON, NON, NON, NON, NON, NON, NON, NON, NON, NON, NON, NON, NON, NON, GOB, NON, NON, NON, NON, NON, NON, NON, NON, NON, NON, NON, NON, NON, NON, NON, IW3, IE3, NON, NON, NON, NON, NON, NON, NON, NON, NON, NON, NON, NON, IW3,
NON, NON, NON, NON, NON, NON, GOB, NON, NON, NON, NON, NON, NON, NON, NON, GOB, NON, NON, NON, NON, NON, NON, NON, GOB, NON, NON, NON, NON, NON, NON, NON, NON, NON, NON, GOB, NON, NON, NON, NON, NON, NON, NON, NON, NON, GOB, NON, NON, NON, NON, NON, NON, NON, NON, NON, NON, NON, NON, NON, NON, IS3, IN4, IN4, IN4, IN4, IN4, IN4, IN4, IN4, IN4, IN4, IN4, IE3, NON, NON, NON, NON, NON, NON, NON, NON, NON, NON, NON, NON, NON, NON, NON, NON, NON, NON, NON, NON, NON, NON, NON, NON, NON, NON, NON, NON, NON, NON, NON, NON, NON, NON, NON, NON, NON, NON, NON, NON, NON, NON, NON, NON, NON, NON, NON, NON, NON, NON, NON, NON, GOB, TCH, NON, IS3, IN3, NON, NON, NON, NON, NON, NON, NON, NON, NON, NON, NON, NON, NON, NON, NON, NON, NON, NON, NON, NON, NON, NON, NON, NON, NON, NON, NON, NON, NON, NON, NON, IS3, IE4, IE3, NON, NON, NON, NON, NON, NON, NON, NON, NON, NON, NON, NON, NON, NON, NON, NON, IW3, IE3, NON, NON, NON, NON, NON, NON, NON, NON, NON, NON, NON, NON, NON, NON, NON, NON, NON, NON, NON, NON, NON, NON, NON, NON, NON, NON, NON, NON, IW3, IE4, IE4, IE3, NON, NON, NON, NON, NON, NON, NON, NON, NON, NON, NON, NON, NON, NON, NON, NON, NON, NON, NON, NON, NON, NON, NON, NON, NON, NON, NON, NON, NON, NON, NON, NON, IW3, IE3, NON, NON, NON, NON, NON, NON, NON, NON, NON, NON, BOB, NON, IW3,
IW2, IN2, IW2, IN2, IW2, IN2, IW2, IN2, IW2, IN2, IW2, IN2, IW2, IN2, IW2, IN2, IW2, IW2, IN2, IW2, IW2, IN2, IW2, IN2, IW2, IN2, IW2, IN2, IW2, IN2, IW2, IN2, IW2, IN2, IW2, IN2, IW2, IW2, IN2, IW2, IW2, IN2, IW2, IN2, IW2, IN2, IW2, IN2, IW2, IN2, IW2, IN2, IW2, IN2, IW2, IN2, IW2, IW2, IN2, IW5, IN4, IN4, IN4, IN4, IN4, IN4, IN4, IN4, IN4, IN4, IN4, IN5, IW2, IN2, IW2, IN2, IW2, IW2, IN2, IW2, IW2, IN2, IW2, IN2, IW2, IN2, IW2, IN2, IW2, IN2, IW2, IN2, IW2, IN2, IW2, IN2, IW2, IW2, IN2, IW2, IW2, IN2, IW2, IN2, IW2, IN2, IW2, IN2, IW2, IN2, IW2, IN2, IW2, IN2, IW2, IN2, IW2, IW2, IN2, IW2, IW2, IN2, IW2, IN2, IW2, IN2, IW2, IW5, IN5, IN2, IW2, IN2, IW2, IN2, IW2, IN2, IW2, IW2, IN2, IW2, IW2, IN2, IW2, IN2, IW2, IN2, IW2, IN2, IW2, IN2, IW2, IN2, IW2, IN2, IW2, IN2, IW2, IW2, IN2, IW2, IW5, IN4, IN5, IN2, IW2, IN2, IW2, IN2, IW2, IN2, IW2, IN2, IW2, IN2, IW2, IN2, IW2, IW2, IN2, IW5, IN5, IN2, IW2, IN2, IW2, IN2, IW2, IN2, IW2, IN2, IW2, IN2, IW2, IN2, IW2, IN2, IW2, IW2, IN2, IW2, IW2, IN2, IW2, IN2, IW2, IN2, IW2, IN2, IW2, IW5, IE4, IE4, IN5, IN2, IW2, IN2, IW2, IW2, IN2, IW2, IW2, IN2, IW2, IN2, IW2, IN2, IW2, IN2, IW2, IN2, IW2, IN2, IW2, IN2, IW2, IN2, IW2, IW2, IN2, IW2, IW2, IN2, IW2, IN2, IW2, IW5, IN5, IN2, IW2, IN2, IW2, IN2, IW2, IN2, IW2, IN2, IW2, IW2, IN2, IW5
